11111111
1E1001C1
1P000011
10101001
11111111
