111111
1E11C1
1P0001
101001
111111
