11111111111
1E000C00111
110CP1100C1
11111111111
