11111111111
10000C0P011
100C1111011
11110111111