11111111111
1CCC0C0P011
100C0101111
1ECC1110011
11111111111