11111111111
1CCC0C0E011
1P0C0101111
1ECC1110111
11111111111