111111
10E0C1
111001
110001
100011
1C10P1
111111