11111111111
10000C0P111
1E0C11100C1
11111111111
