11111111111
10000C0P011
100C0011011
1ECC0000011
11111111111