11111111111
10000C0P011
100C1111011
1ECC0000001
11111111111