11111111111111111111111111111111111111111
11111111111111111111111111111111111111111
11111111111111111111111111111111111111111
11111111111111111111111111111111111111111
11111111111111111111111111111111111111111
11111111111111111111111111111111111111111
11111111111111111100011111111111111111111
1111111111111100000P000001111111111111111
11111111111100000000000000011111111111111
11111111111000000000000000001111111111111
11111111110000000100010000000111111111111
11111111100100101100011010000011111111111
11111111100001100000000011000011111111111
11111111000011000000000001100001111111111
10000111000000000000000000000C01111111111
10000011000010000110110000100001111111111
10000000000110101100011000110101111111111
10000010000100000000000000010000111111111
10000000C0000000000E0000000000C0111111111
10000010000100000000000000010000111111111
10000000000110001100011000110001111111111
10000011000010000110110000100001111111111
10000111000000000000000000000001111111111
11111111000011000000000000000001111111111
11111111100001100000000000000011111111111
11111111100000101100011010000011111111111
11111111110000000100010000000111111111111
111111111110000000000000C0001111111111111
11111111111100000000001000011111111111111
1111111111111100000C000001111111111111111
11111111111111111100011111111111111111111
11111111111111111111111111111111111111111
11111111111111111111111111111111111111111
11111111111111111111111111111111111111111
11111111111111111111111111111111111111111
11111111111111111111111111111111111111111
11111111111111111111111111111111111111111
11111111111111111111111111111111111111111
11111111111111111111111111111111111111111
11111111111111111111111111111111111111111
