11111111
1P0000C1
111E0001
11111111