11111111111111
1C000000000001
10000C00P00001
11111100001111
1E10000C001111
11111111111111