11111111111111
1C000000000001
10000C00P00111
1E00000C0011C1
11111111111111