11111111111111111111111111111111111111111111111111111111111111111111111111111111111111111111111111111111
11111111111111111111111111111111111111111111111111111111111111111111111111111111111111111111111111111111
11111111000000011111111111111111111111111111111111111111111111111111111111111111111111111111111111111111
11110000000000001111111111111111111111111100000000000011111111111111111111111111111111111111111111111111
11110000000000000000000011111111111100000000000000000000000011111111111111111111111111111111111111111111
11110000000000000000000000000000000000000000000000000100000000000011111111111111111111111111111111111111
1111000000P000000000100000000000000000000000100000000000000000000000001111111111111111111111111111111111
111000000000000000001000000C00000010000000000000001000000000000C0000001111111111111111111111111111111111
11100000000000000000100000000000000000000000000000000000000000000000111111111111111111111111111111111111
11111000000000000000000000000000000000000000000000001111111111111111111111111111111111111111111111111111
11111110000000000000000000000000000000000100000111111110111111111111111111000000011111111001111111111111
11111111111111111000000000000000000000000000000111111100001111111111100000000000000001110001111111111111
1111111111111111111000000111110000000000000000011111000010011111111110000000C000000000000000000011111111
111111111111111111110000000000000000000000000000000000C0001111111111111110000000000000000001111111111111
11111111111111111110000000000000000000000000000000000000011111111111111111100000000011111111111111111111
11111111000000000111000000000000000000000000000111100001111111111111111111111110000000111111111111111111
11111111000000000110000000000000000011111111111111111111111111111111111111111111100011111111111111111111
111111110000C0000000000000000000001111111111111111111111111111111111111111111111100000111111111111111111
11111111000000000110000000000000000000111111111111111111111111111111111111111111110000000011111111111111
11111111110111011110000000000000000000000000000001111111111111111111111111111110000000000000111111111111
11111111100000000000000000000000000000000000000000000000000000000000000000000000000000000000000011111111
11111110000000000000000000000000000000000000000000000000000000000000000000000000000000000000000000111111
11111000000000000000000000000000000000001000000000000000000000000000000000000000000000000000000000111111
11111000000000000000000000000000000010001000000000000000000000000000000000000000000000000000000001111111
11111000000000000001111111110000000000000000000000000000000000000000000000000000000000000000000001111111
11110000000000011111100000111100011000000000000000000000000000000000000000000000000000000000000011111111
11110000000000011000000C00000110000000001000000000000000000000000111111000000000000000000001111111111111
111100000000001110C00000000C0110000000000000000000000000000000011111111111111111000000001111111111111111
11110000000000011111110001111100000000000000000000000000000001111111111111111111111111011111111111111111
11111110000000000000000000000000000000000000000000000000001001111111111111111111111111011111111111111111
11111111111000000000000000000000000000000000010000000000000000111111111111111111111111011111111111111111
11111111111110000000000000000000000000000000000001000000001000000111111111111111111111011111111111111111
11111111111111011111111000000000000011111111000000000000000000000000111111111111111100000111111111111111
11111111111111011111111111111111101111111111111100001000000001000000000000111111111101110000111111111111
11111111111111011111110000111111101111111111111111000000000000000100000000001111111101011110111111111111
11111111111111011111100000011111101111111111111111100010000000000000000000000001111100000000011111111111
11111111110000000000000000000000000000111111111111100000000000000000000000000000001111011111011111111111
11111111110000000000000000000000000000111111111111110000000000000000010000000000000011011111011111111111
11111111110000000000000000000000000000111111111111110000000000000000000000000000000011010000000001111111
1111111111101111111111100111111111110111111111111110000000000000000001000000C000000011010101111101111111
11111111110000111111100000011111110000111111111111000000000100000000000000000000000101011101111101111111
111111111100C0000000000000000000000C001111111111110000C000010000E000010000000000001100000000000001111111
11111111111000110001100000011000110001111111111111000000000100000000000000000000011111011101111101111111
11111111111111111111100000011111111111111111111111100000000100000000000000000000000000000000000001111111
11111111111111111111111111111111111111111111111111100000000000011111000000000000011111111111111111111111
11111111111111111111111111111111111111111111111111100000000000000000000000000000111111111111111111111111
11111111111111111111111111111111111111111111111111110000000000000000000000000001111111111111111111111111
11111111111111111111111111111111111111111111111111110000000000000C00000000000001111111111111111111111111
11111111111111111111111111111111111111111111111111111100000000000000000000011111111111111111111111111111
11111111111111111111111111111111111111111111111111111111111111000000111111111111111111111111111111111111
11111111111111111111111111111111111111111111111111111111111111111111111111111111111111111111111111111111
11111111111111111111111111111111111111111111111111111111111111111111111111111111111111111111111111111111
11111111111111111111111111111111111111111111111111111111111111111111111111111111111111111111111111111111
11111111111111111111111111111111111111111111111111111111111111111111111111111111111111111111111111111111
11111111111111111111111111111111111111111111111111111111111111111111111111111111111111111111111111111111
11111111111111111111111111111111111111111111111111111111111111111111111111111111111111111111111111111111





















