11111111111111111111111111111111111111111111111111111111111111111
10000000000000000000000000000000000000000000000000111111111111111
1000000000000000000000000000000000C000000000000000111111111111111
10000000000000000000000000100000000000000100000000111111111111111
10001111000000000000000000100011110101001100000000111111111111111
1000000000000C00000000000010000100000000000000C000000000000000001
10000000110000111111000000100C01000000000000000000000000000000001
10000000100000000000000000100001000000000000000000000000000000001
100000001000000000000000C11111111111111100000000000000000000P0001
10000000000001000001000001000000000000010000000000000000000000001
10000000000000000001000001000000000000010000000000000000000000001
10000000111000000111000011001000000010011000000000011111111111111
10000C00001000000100000000001000000010000000000000010000000000001
10000000001000000100000000001000E00010000000111000010000C00000001
10000000001100011100000000001000000010000000000000010000000000001
10000000000000000000000011001000000010011000000000010000000000001
10000000000000000C00000001000000000000010000000000010000000000001
10011000000000000000000001000000000000010000000000010000000000001
10011000000000000000000001111111111111110010010011111111100001111
10000000000000000000000000000000000000000000000010000000000000001
1000000000010001000100000000000000000000000000C010000000000000001
1000000C000000000000000000000000000000000000000011100011111000111
10000000000000000000000001001001000000111111111110000000100000001
10001000000000000000000000000000000000000000000000000000100000001
10000000000000000001000000000000000000000000000000000111111111111
10000000000100000000000001001001000000000001111111111111111111111
10011000000000000000000000000000000000000001111110000000000000001
100110000000C000000000000000000000000000000000000000000C000000001
10000000000100010001000001001001000000000000000000000000000000001
11111110011111111111111111111111110011111111111111111100011111111
11111110011111111111111111111111110011111111111111111100011111111
11111110011111111111111111111111110011111111111111111100011111111
11111000000100000000000000000001000000111111111111111100011111111
111110000001000C00000000000C0001000000111111111111111100011111111
11111000000100000000000000000001000000111111111111111100011111111
11111000000100000000000000000001000000111111111111111100011111111
11111100000000010001000100010000000001111111100001111100011111111
11111100000000000000000000000000000001111100000000001100011111111
11111100000100000000000000000001000001111100C00000001100011111111
11111100000000010001000100010000000001111100000000000000011111111
1111111000C000000000000000000000C000111111000000C0000000011111111
111111100000000000000C0000000000000011111100000000001100011111111
111111100000000000000000000000000000111111000C0000001100011111111
11111111110000000000000000000000011111111100000000001111111111111
11111111111111111100000001111111111111111111111111111111111111111
11111111111111111111111111111111111111111111111111111111111111111
11111111111111111111111111111111111111111111111111111111111111111
11111111111111111111111111111111111111111111111111111111111111111
