1111111111111111111111111111111
1111101101101101101101101101111
1111101101101101101101101101111
1111101101101101101101101101111
10000000C00000000C00000000C0001
1P000C00000000C00000C00000000E1
10000000000C00000000000C0000001
1111101101101101101101101101111
1111101101101101101101101101111
1111101101101101101101101101111
1111111111111111111111111111111
